1	1	1	1	1	1	1	1	1	1	1	1	1	1	1	1	1	1	1	1	1	1	1	1	1	1	1	1	1	1	1	1	1	1	1	1	1	1	1	1	1	1	1	1	1	1	1	1	1	1	1	1	1	1	1	1	1	1	1	1	1	1	1	1	1	1	1	1	1	1	1	1	1	1	1	1	1	1	1	1	1	1	1	1	1	1	1	1	1	1	1	1	1	1	1	1	1	1	1	1	1	1	1	1	1	1	1	1	1	1	1	1	1	1	1	1	1	1	1	1	1	1	1	1	1	1	1	1	1	1	1	1	1	1	1	1	1	1	1	1	1	1	1	1	1	1	1	1	1	1	1	1	1	1	1	1	1	1	1	1	1	1	1	1	1	1	1	1	1	1	1	1	1	1	1	1	1	1	1	1	1	1	1	1	1	1	1	1	1	1	1	1	1	1	1	1	1	1	1	1	1	1	1	1	1	1	1	1	1	1	1	1	1	1	1	1	1	1	1	1	1	1	1	1	1	1	1	1	1	1	1	1	1	1	1	1	1	1	1	1	1	1	1	1	1	1	1	1	1	1	1	1	1	1	1	1	1	1	1	1	1	1	1	1	1	1	1	1	1	1	1	1	1	1	1	1	1	1	1	1	1	1	1	1	1	1	1	1	1	1	1	1	1	1	1	1	1	1	1	1
1	-1	-1	8	-1	-1	8	-1	-1	-1	8	-1	-1	-1	-1	-1	8	-1	9	9	9	-1	8	-1	-1	-1	2	6	9	2	-1	8	-1	-1	-1	-1	8	-1	-1	-1	8	-1	-1	-1	-1	-1	-1	-1	-1	-1	-1	-1	-1	-1	-1	-1	-1	-1	-1	-1	-1	-1	-1	-1	-1	-1	-1	-1	-1	-1	-1	-1	-1	-1	-1	-1	-1	-1	-1	-1	-1	-1	-1	-1	-1	-1	-1	-1	-1	-1	2	3	4	3	2	3	4	3	2	3	4	3	2	3	4	3	2	-1	-1	-1	-1	-1	-1	-1	-1	-1	-1	-1	2	2	2	2	2	2	2	-1	-1	-1	-1	-1	-1	-1	8	-1	-1	-1	-1	-1	-1	-1	-1	-1	8	-1	-1	-1	-1	-1	-1	2	8	2	-1	2	-1	8	2	2	2	8	2	2	2	7	-1	-1	7	2	9	3	3	9	2	7	-1	-1	-1	-1	-1	-1	-1	-1	-1	-1	-1	-1	-1	-1	-1	-1	-1	-1	-1	-1	-1	-1	-1	-1	-1	-1	-1	-1	9	-1	-1	9	-1	9	-1	-1	9	-1	-1	-1	8	2	-1	-1	2	-1	8	2	-1	8	2	-1	-1	-1	8	-1	-1	-1	-1	-1	8	-1	-1	-1	-1	8	-1	-1	-1	-1	8	3	-1	-1	-1	3	-1	-1	-1	3	8	-1	-1	-1	8	-1	-1	-1	-1	-1	-1	-1	8	-1	-1	-1	-1	-1	-1	-1	8	-1	-1	-1	-1	-1	8	-1	-1	-1	-1	3	-1	3	-1	3	-1	3	-1	3	-1	3	-1	3	-1	1
1	-1	-1	-1	-1	-1	-1	-1	-1	-1	-1	-1	-1	-1	-1	-1	-1	-1	-1	9	-1	-1	-1	-1	-1	-1	2	2	2	2	-1	-1	-1	-1	-1	-1	-1	-1	-1	-1	-1	-1	-1	-1	-1	-1	-1	-1	-1	-1	-1	-1	-1	-1	-1	-1	-1	-1	-1	-1	-1	-1	-1	-1	-1	-1	-1	-1	-1	-1	-1	-1	-1	-1	-1	-1	-1	-1	-1	-1	-1	-1	-1	-1	-1	-1	-1	-1	-1	-1	8	2	3	2	8	2	3	2	8	2	3	2	8	2	3	2	8	-1	-1	-1	-1	-1	-1	-1	-1	-1	-1	-1	-1	2	3	2	3	2	-1	-1	-1	-1	-1	-1	-1	-1	-1	-1	-1	-1	-1	-1	-1	-1	-1	-1	-1	-1	-1	-1	-1	-1	2	-1	2	-1	2	-1	2	-1	-1	2	-1	-1	-1	2	-1	-1	-1	-1	-1	2	9	3	3	9	2	-1	-1	-1	-1	-1	-1	-1	-1	-1	-1	-1	-1	-1	-1	-1	-1	-1	-1	-1	-1	-1	-1	-1	-1	-1	-1	-1	-1	-1	9	-1	-1	9	-1	9	-1	-1	9	-1	-1	-1	-1	-1	2	2	-1	2	2	-1	2	2	-1	-1	-1	-1	-1	-1	-1	-1	-1	-1	-1	-1	-1	-1	-1	-1	-1	-1	-1	-1	-1	-1	3	-1	3	-1	3	-1	3	-1	-1	-1	-1	-1	-1	-1	-1	-1	-1	-1	-1	-1	-1	-1	-1	-1	-1	-1	-1	-1	-1	-1	-1	-1	-1	-1	-1	-1	-1	-1	-1	-1	3	-1	3	-1	3	-1	3	-1	3	-1	3	-1	3	1
1	-1	-1	-1	-1	-1	-1	-1	-1	-1	-1	-1	-1	-1	-1	-1	-1	-1	-1	-1	-1	-1	-1	-1	-1	-1	2	2	2	2	-1	-1	-1	-1	-1	-1	-1	-1	-1	-1	-1	-1	-1	-1	-1	-1	-1	-1	-1	-1	-1	-1	-1	-1	-1	-1	-1	-1	-1	-1	-1	-1	-1	-1	10	10	10	10	-1	-1	-1	-1	-1	-1	-1	-1	-1	-1	-1	12	10	10	10	10	-1	-1	-1	-1	-1	-1	-1	8	2	8	-1	8	2	8	-1	8	2	8	-1	8	2	8	-1	-1	-1	-1	-1	-1	-1	-1	-1	-1	-1	-1	-1	-1	2	2	2	-1	-1	-1	-1	-1	-1	-1	-1	-1	-1	-1	-1	-1	-1	-1	-1	-1	-1	-1	-1	-1	-1	-1	-1	-1	-1	-1	-1	-1	-1	-1	-1	-1	-1	-1	-1	-1	-1	-1	-1	-1	-1	-1	-1	2	9	3	3	9	2	-1	-1	-1	-1	-1	-1	-1	-1	-1	-1	-1	-1	-1	-1	-1	-1	-1	-1	-1	-1	-1	-1	-1	-1	-1	-1	-1	-1	-1	9	9	9	9	9	9	9	9	9	-1	-1	-1	-1	-1	-1	-1	-1	-1	-1	-1	-1	-1	-1	-1	-1	-1	-1	-1	-1	-1	-1	-1	-1	-1	-1	-1	-1	-1	-1	-1	-1	-1	-1	-1	-1	3	-1	-1	-1	3	-1	-1	-1	-1	-1	-1	-1	-1	-1	-1	-1	-1	-1	-1	-1	-1	-1	-1	-1	-1	-1	-1	-1	-1	-1	-1	-1	-1	-1	-1	-1	-1	-1	-1	-1	-1	-1	-1	-1	-1	-1	-1	-1	-1	-1	-1	-1	1
1	-1	-1	-1	-1	-1	-1	-1	-1	-1	-1	-1	-1	-1	-1	-1	-1	-1	-1	-1	-1	-1	-1	-1	-1	-1	-1	-1	-1	-1	-1	-1	-1	-1	-1	-1	-1	-1	-1	-1	-1	-1	-1	-1	-1	-1	-1	-1	-1	-1	-1	-1	-1	-1	-1	-1	-1	-1	-1	-1	2	2	2	2	2	2	2	2	2	2	0	0	0	0	0	0	0	2	2	2	2	2	2	2	2	-1	-1	-1	-1	-1	-1	-1	-1	-1	-1	-1	-1	-1	-1	-1	-1	-1	-1	-1	-1	-1	-1	-1	-1	-1	-1	-1	-1	-1	-1	-1	-1	-1	-1	-1	-1	2	-1	-1	-1	-1	-1	-1	-1	-1	-1	-1	-1	-1	-1	-1	-1	-1	-1	-1	-1	-1	-1	-1	-1	-1	-1	-1	-1	-1	-1	-1	-1	-1	-1	-1	-1	-1	-1	-1	-1	-1	-1	-1	-1	-1	-1	2	2	2	2	2	2	-1	-1	-1	-1	-1	-1	-1	-1	-1	10	10	10	10	10	10	10	-1	-1	-1	-1	-1	-1	-1	-1	-1	-1	-1	-1	-1	-1	-1	-1	-1	-1	-1	-1	-1	-1	-1	-1	-1	-1	-1	-1	-1	-1	-1	-1	-1	-1	-1	-1	-1	-1	-1	-1	-1	-1	-1	-1	-1	-1	-1	-1	-1	-1	-1	-1	-1	-1	-1	-1	-1	-1	-1	-1	-1	-1	-1	-1	-1	-1	-1	-1	-1	-1	-1	-1	-1	-1	-1	-1	-1	-1	-1	-1	-1	-1	-1	-1	-1	-1	-1	-1	-1	-1	-1	-1	-1	-1	-1	-1	-1	-1	-1	-1	-1	-1	-1	-1	-1	-1	-1	-1	-1	-1	1
1	-1	-1	-1	-1	-1	-1	-1	-1	-1	-1	-1	-1	-1	-1	-1	-1	-1	-1	-1	-1	-1	-1	-1	-1	-1	-1	-1	-1	-1	-1	-1	-1	-1	-1	-1	-1	-1	-1	-1	-1	-1	-1	-1	-1	-1	-1	-1	-1	-1	-1	-1	-1	-1	-1	-1	-1	-1	-1	-1	-1	-1	-1	-1	-1	-1	-1	-1	-1	-1	-1	-1	-1	-1	-1	-1	-1	-1	-1	-1	-1	-1	-1	-1	-1	-1	-1	-1	-1	-1	-1	-1	-1	-1	-1	-1	-1	-1	-1	-1	-1	-1	-1	-1	-1	-1	-1	-1	-1	-1	-1	-1	-1	-1	-1	11	-1	-1	-1	-1	-1	2	-1	-1	-1	-1	-1	12	-1	-1	-1	-1	-1	-1	-1	-1	-1	-1	-1	-1	-1	-1	-1	-1	-1	-1	-1	-1	-1	-1	-1	-1	-1	-1	-1	-1	-1	-1	-1	-1	-1	-1	-1	-1	-1	-1	-1	-1	-1	-1	-1	-1	-1	-1	-1	0	0	0	0	0	0	0	2	2	2	2	2	2	2	-1	-1	-1	-1	-1	-1	-1	-1	-1	-1	-1	-1	-1	-1	-1	-1	-1	-1	-1	-1	-1	-1	-1	-1	-1	-1	-1	-1	-1	-1	-1	-1	-1	-1	-1	-1	-1	-1	-1	-1	-1	-1	-1	-1	-1	-1	-1	-1	-1	-1	-1	-1	-1	-1	-1	-1	-1	-1	-1	-1	-1	-1	-1	-1	-1	-1	10	10	10	10	10	10	10	10	10	-1	-1	-1	-1	-1	-1	-1	-1	-1	-1	-1	-1	-1	-1	-1	-1	-1	-1	-1	-1	-1	-1	-1	-1	-1	-1	-1	-1	-1	-1	-1	-1	-1	-1	-1	1
1	-1	-1	-1	-1	-1	-1	-1	-1	-1	-1	-1	-1	2	2	2	2	2	2	2	2	2	2	2	2	-1	-1	-1	-1	-1	-1	-1	-1	-1	-1	-1	10	10	10	10	10	10	10	10	10	10	10	10	10	10	10	10	-1	-1	-1	-1	-1	-1	-1	-1	-1	-1	-1	-1	-1	-1	-1	-1	-1	-1	-1	-1	-1	-1	-1	-1	-1	-1	-1	-1	-1	-1	-1	-1	-1	-1	-1	-1	-1	-1	-1	-1	-1	-1	-1	-1	-1	-1	-1	-1	-1	-1	-1	-1	-1	-1	-1	-1	-1	-1	-1	-1	-1	-1	10	2	10	-1	-1	-1	-1	-1	-1	-1	-1	-1	10	2	10	-1	-1	-1	-1	-1	-1	-1	-1	-1	-1	-1	-1	10	10	10	10	10	10	10	-1	-1	-1	-1	-1	-1	-1	-1	-1	-1	-1	-1	-1	-1	-1	-1	-1	-1	-1	-1	-1	-1	-1	-1	-1	-1	-1	-1	-1	-1	-1	-1	-1	-1	-1	-1	-1	-1	-1	-1	-1	2	-1	-1	-1	-1	-1	-1	-1	-1	-1	-1	-1	-1	-1	-1	-1	-1	-1	-1	-1	-1	-1	-1	-1	-1	-1	-1	-1	-1	-1	-1	-1	-1	-1	-1	-1	-1	-1	-1	-1	-1	-1	-1	-1	-1	-1	-1	-1	-1	-1	-1	-1	-1	-1	-1	-1	-1	-1	-1	-1	-1	-1	-1	2	2	2	2	2	2	2	2	2	2	2	2	2	2	2	-1	-1	-1	-1	-1	-1	-1	-1	-1	-1	2	0	0	0	2	-1	-1	-1	-1	-1	-1	-1	-1	-1	-1	-1	-1	-1	-1	-1	-1	-1	1
1	-1	-1	-1	-1	-1	-1	-1	-1	-1	-1	-1	-1	2	2	2	3	3	3	3	3	3	2	2	2	-1	-1	-1	-1	-1	-1	-1	-1	-1	-1	2	2	2	2	2	2	2	2	2	2	2	2	2	2	2	2	2	2	-1	-1	-1	-1	-1	-1	-1	-1	-1	-1	-1	-1	-1	-1	-1	-1	10	10	10	10	10	10	10	10	-1	-1	-1	-1	-1	-1	-1	-1	-1	-1	-1	-1	-1	-1	-1	-1	-1	-1	-1	-1	-1	-1	-1	-1	-1	-1	-1	-1	-1	-1	-1	-1	-1	-1	-1	-1	10	2	3	2	10	-1	-1	-1	-1	-1	-1	-1	10	2	3	2	10	-1	-1	-1	-1	-1	-1	-1	-1	-1	-1	-1	2	2	2	2	2	2	2	-1	-1	-1	-1	-1	-1	-1	-1	-1	-1	-1	-1	-1	-1	-1	-1	-1	-1	-1	-1	-1	-1	-1	-1	-1	-1	-1	-1	-1	-1	-1	-1	-1	-1	-1	-1	-1	-1	-1	-1	-1	-1	2	10	10	10	10	10	10	10	10	10	-1	-1	-1	-1	-1	-1	-1	-1	-1	-1	-1	10	10	10	10	10	10	10	-1	-1	-1	-1	-1	-1	-1	-1	-1	-1	-1	-1	-1	-1	-1	-1	-1	-1	-1	-1	-1	-1	-1	-1	-1	-1	-1	-1	-1	-1	-1	-1	-1	-1	2	2	3	-1	3	-1	3	-1	3	-1	3	-1	3	2	2	-1	10	10	10	-1	-1	-1	-1	-1	-1	2	-1	-1	-1	2	-1	-1	-1	-1	-1	10	10	10	10	10	10	10	10	10	10	-1	-1	1
1	-1	-1	-1	-1	-1	-1	-1	-1	-1	-1	-1	-1	-1	-1	-1	3	3	10	10	3	3	-1	-1	-1	-1	-1	-1	-1	-1	-1	-1	-1	-1	2	2	9	8	8	8	8	8	8	8	9	8	8	8	8	8	8	8	9	2	-1	-1	-1	-1	-1	-1	-1	-1	-1	-1	-1	-1	-1	-1	-1	2	2	2	2	2	2	2	2	-1	-1	-1	-1	-1	-1	-1	-1	-1	-1	-1	-1	-1	-1	-1	-1	-1	-1	-1	-1	-1	-1	-1	-1	-1	-1	-1	-1	-1	-1	-1	-1	-1	-1	-1	10	2	9	3	9	2	10	-1	-1	-1	-1	-1	10	2	9	3	9	2	10	-1	-1	-1	-1	-1	-1	-1	-1	-1	-1	2	3	3	3	3	3	2	-1	-1	-1	-1	-1	-1	-1	-1	-1	-1	-1	-1	-1	-1	-1	-1	-1	-1	-1	-1	-1	-1	-1	-1	-1	-1	-1	-1	10	10	10	10	10	-1	-1	-1	-1	-1	-1	-1	-1	-1	-1	2	2	2	2	2	2	2	2	2	-1	-1	-1	10	10	10	10	10	10	-1	-1	2	2	2	2	2	2	2	-1	-1	-1	10	10	10	10	10	-1	-1	-1	-1	-1	-1	-1	-1	-1	-1	-1	-1	-1	-1	-1	10	10	10	10	10	10	10	10	-1	-1	-1	2	2	-1	3	-1	3	-1	3	-1	3	-1	3	-1	2	2	2	2	2	2	2	-1	-1	-1	-1	-1	3	3	10	3	3	-1	-1	-1	-1	-1	2	2	2	2	2	2	2	2	2	2	2	2	1
1	-1	-1	-1	-1	-1	-1	-1	-1	-1	-1	-1	-1	-1	-1	-1	3	3	10	10	3	3	-1	-1	-1	-1	-1	-1	-1	-1	-1	-1	-1	2	3	2	9	9	7	-1	-1	-1	7	9	3	9	7	-1	-1	-1	7	9	9	3	2	-1	-1	-1	-1	-1	-1	-1	-1	-1	-1	-1	-1	-1	2	9	3	3	3	3	3	3	9	2	-1	-1	-1	-1	-1	-1	-1	-1	-1	-1	-1	-1	-1	-1	-1	-1	-1	-1	-1	-1	-1	-1	-1	-1	-1	-1	-1	-1	-1	-1	-1	-1	-1	10	2	3	9	3	9	3	2	10	-1	-1	-1	10	2	3	9	3	9	3	2	10	-1	-1	-1	-1	-1	-1	-1	-1	-1	2	3	2	2	2	3	2	-1	-1	2	2	2	2	2	2	2	2	-1	-1	-1	-1	-1	-1	-1	-1	-1	-1	-1	-1	-1	2	2	2	2	2	2	2	2	2	2	2	-1	-1	-1	-1	-1	-1	-1	-1	-1	-1	-1	-1	-1	-1	-1	-1	-1	-1	-1	-1	-1	2	2	2	2	2	2	-1	-1	2	3	2	2	2	3	2	-1	-1	-1	2	2	2	2	2	10	10	10	10	10	10	10	10	10	10	-1	-1	-1	2	2	2	2	2	2	2	2	2	2	2	2	2	2	2	-1	-1	3	-1	3	-1	3	-1	3	-1	-1	2	2	-1	-1	-1	-1	2	-1	-1	-1	-1	-1	3	3	10	3	3	-1	-1	-1	-1	-1	2	-1	3	-1	3	-1	3	-1	3	-1	3	-1	1
1	2	2	2	2	2	2	2	2	2	2	2	10	2	2	2	2	2	2	2	2	2	2	2	-1	-1	-1	-1	-1	-1	-1	-1	2	3	3	2	9	9	9	7	-1	7	9	9	3	9	9	7	-1	7	9	9	9	3	3	2	-1	-1	-1	-1	-1	-1	-1	-1	-1	-1	-1	2	3	9	3	3	3	3	3	3	9	3	2	10	10	10	5	10	10	10	-1	-1	-1	-1	-1	-1	-1	-1	-1	-1	-1	-1	-1	-1	-1	-1	-1	-1	-1	-1	-1	-1	-1	-1	10	2	9	3	9	3	9	3	9	2	10	-1	10	2	9	3	9	3	9	3	9	2	10	-1	-1	-1	-1	-1	-1	-1	-1	2	3	2	2	2	3	2	-1	-1	2	8	3	2	3	8	2	3	2	-1	-1	-1	10	10	10	10	10	-1	-1	-1	2	3	2	8	-1	8	2	8	-1	8	2	2	-1	-1	-1	-1	-1	-1	-1	-1	-1	-1	-1	-1	-1	-1	-1	-1	-1	-1	-1	-1	-1	2	3	3	3	3	2	-1	-1	2	2	3	2	3	2	2	-1	-1	-1	2	3	3	3	2	2	2	2	2	2	2	2	2	2	2	-1	-1	-1	2	2	2	2	3	3	3	2	3	3	3	2	2	2	2	-1	3	-1	3	-1	3	-1	3	-1	3	-1	2	2	-1	-1	-1	-1	2	-1	-1	2	2	2	2	2	2	2	2	-1	-1	-1	-1	-1	2	3	-1	3	-1	3	-1	3	-1	3	-1	3	1
1	2	9	3	9	3	9	3	9	3	9	2	10	2	6	9	6	3	3	6	9	6	2	4	2	10	10	10	10	10	10	2	3	3	3	2	9	9	9	9	7	9	9	9	3	9	9	9	7	9	9	9	9	3	3	3	2	2	2	2	2	2	2	2	2	2	2	3	3	9	3	3	3	3	3	3	9	3	3	2	2	2	2	2	2	2	-1	-1	-1	-1	-1	-1	-1	-1	-1	-1	-1	-1	-1	-1	-1	-1	-1	-1	-1	-1	-1	-1	-1	10	2	3	9	3	9	3	9	3	9	3	2	10	2	3	9	3	9	3	9	3	9	3	2	10	-1	-1	-1	-1	-1	-1	-1	2	3	3	3	3	3	2	-1	-1	2	-1	2	3	2	-1	2	9	3	2	2	2	2	2	2	2	2	2	2	2	3	9	-1	2	-1	2	8	2	-1	2	-1	2	-1	-1	-1	-1	-1	-1	-1	-1	-1	-1	-1	-1	-1	-1	-1	-1	-1	-1	-1	-1	-1	2	3	3	3	3	2	-1	-1	2	2	2	3	2	2	2	-1	-1	-1	2	3	3	3	2	3	-1	3	-1	3	-1	3	-1	3	2	-1	-1	-1	2	4	2	-1	2	3	2	-1	2	3	2	4	2	2	2	3	-1	3	-1	3	-1	3	-1	3	-1	3	2	2	-1	-1	-1	-1	2	-1	-1	2	2	2	2	2	2	2	2	-1	-1	-1	-1	-1	2	-1	3	-1	3	-1	3	-1	3	-1	3	-1	1
1	2	3	9	3	9	3	9	3	9	3	2	5	2	6	9	6	3	3	6	9	6	2	4	4	2	2	2	2	2	2	2	3	3	3	2	4	9	9	4	9	4	9	9	3	9	9	4	9	4	9	9	4	3	3	3	2	2	2	2	2	2	2	2	2	2	2	4	4	9	3	3	3	3	3	3	9	4	4	2	2	2	2	2	2	2	-1	10	10	10	10	10	10	10	10	10	5	5	5	10	10	10	10	10	10	10	10	10	-1	2	9	3	9	3	9	3	9	3	9	3	9	2	9	3	9	3	9	3	9	3	9	3	9	2	5	5	5	5	5	5	5	2	2	2	2	2	2	2	5	5	2	4	3	2	3	4	2	9	4	3	3	3	3	3	3	3	3	3	3	3	4	9	-1	4	2	4	-1	4	2	4	-1	2	-1	-1	-1	-1	-1	-1	-1	-1	-1	-1	-1	-1	-1	-1	-1	-1	-1	-1	-1	-1	-1	2	2	2	2	2	2	5	5	2	2	3	2	3	2	2	5	5	5	2	2	2	2	2	-1	3	-1	3	-1	3	-1	3	-1	2	5	5	5	2	2	2	-1	-1	2	-1	-1	-1	2	-1	2	2	2	2	-1	3	-1	-1	-1	3	-1	-1	-1	3	-1	2	2	-1	-1	-1	-1	2	5	5	2	2	2	2	2	2	2	2	5	5	5	5	5	2	3	-1	3	-1	3	-1	3	-1	3	-1	3	1
1	1	1	1	1	1	1	1	1	1	1	1	1	1	1	1	1	1	1	1	1	1	1	1	1	1	1	1	1	1	1	1	1	1	1	1	1	1	1	1	1	1	1	1	1	1	1	1	1	1	1	1	1	1	1	1	1	1	1	1	1	1	1	1	1	1	1	1	1	1	1	1	1	1	1	1	1	1	1	1	1	1	1	1	1	1	1	1	1	1	1	1	1	1	1	1	1	1	1	1	1	1	1	1	1	1	1	1	1	1	1	1	1	1	1	1	1	1	1	1	1	1	1	1	1	1	1	1	1	1	1	1	1	1	1	1	1	1	1	1	1	1	1	1	1	1	1	1	1	1	1	1	1	1	1	1	1	1	1	1	1	1	1	1	1	1	1	1	1	1	1	1	1	1	1	1	1	1	1	1	1	1	1	1	1	1	1	1	1	1	1	1	1	1	1	1	1	1	1	1	1	1	1	1	1	1	1	1	1	1	1	1	1	1	1	1	1	1	1	1	1	1	1	1	1	1	1	1	1	1	1	1	1	1	1	1	1	1	1	1	1	1	1	1	1	1	1	1	1	1	1	1	1	1	1	1	1	1	1	1	1	1	1	1	1	1	1	1	1	1	1	1	1	1	1	1	1	1	1	1	1	1	1	1	1	1	1	1	1	1	1	1	1	1	1	1	1	1	1	1
