1	1	1	1	1	1	1	1	1	1	1	1	1	1	1	1	1	1	1	1	1	1	1	1	1	1	1	1	1	1	1	1	1	1	1	1	1	1	1	1	1	1	1	1	1	1	1	1	1	1	1	1	1	1	1	1	1	1	1	1	1	1	1	1	1	1	1	1	1	1	1	1	1	1	1	1	1	1	1	1	1	1	1	1	1	1	1	1	1	1	1	1	1	1	1	1	1	1	1	1	1	1	1	1	1	1	1	1	1	1	1	1	1	1	1	1	1	1	1	1	1	1	1	1	1	1	1	1	1	1	1	1	1	1	1	1	1	1	1	1	1	1	1	1	1	1	1	1	1	1	1	1	1	1	1	1	1	1	1	1	1	1	1	1	1	1	1	1	1	1	1	1	1	1	1	1	1	1	1	1	1	1	1	1	1	1	1	1	1	1	1	1	1	1	1	1	1	1	1	1	1	1	1	1	1	1	1	1	1	1	1	1	1	1	1	1	1	1	1	1	1	1	1	1	1	1	1	1	1	1	1	1	1	1	1	1	1	1	1	1	1	1	1	1	1	1	1	1	1	1
1	-1	-1	-1	-1	-1	-1	10	-1	-1	10	-1	-1	-1	-1	-1	-1	-1	-1	-1	-1	10	-1	-1	10	-1	-1	10	10	10	-1	-1	-1	-1	10	-1	10	-1	-1	9	-1	-1	10	-1	-1	10	-1	-1	-1	10	2	10	-1	-1	-1	10	2	-1	-1	10	-1	-1	2	10	-1	-1	-1	-1	2	-1	10	-1	9	-1	7	-1	-1	10	-1	-1	10	10	10	10	10	10	10	-1	-1	-1	-1	-1	-1	-1	-1	-1	-1	-1	-1	-1	-1	-1	-1	-1	-1	-1	1	4	-1	4	1	4	-1	4	1	4	-1	4	1	3	3	2	1	4	10	4	1	2	3	3	1	4	-1	4	1	4	-1	4	1	4	-1	4	1	-1	-1	-1	-1	-1	-1	-1	-1	-1	-1	-1	-1	-1	-1	-1	-1	-1	-1	-1	-1	-1	-1	-1	-1	-1	-1	-1	-1	-1	2	9	9	9	2	9	9	9	2	9	9	9	2	9	9	9	2	-1	-1	-1	-1	-1	-1	-1	-1	-1	-1	-1	-1	-1	-1	-1	-1	-1	-1	-1	-1	-1	-1	-1	10	10	10	10	10	-1	2	3	4	3	2	10	-1	10	-1	-1	-1	-1	-1	-1	-1	10	-1	-1	10	-1	10	-1	-1	10	-1	-1	-1	10	-1	10	-1	1
1	-1	-1	-1	-1	-1	-1	-1	-1	-1	-1	-1	-1	-1	-1	-1	-1	-1	-1	-1	-1	-1	-1	-1	-1	-1	-1	-1	-1	-1	-1	-1	-1	-1	-1	-1	-1	-1	-1	-1	-1	-1	-1	-1	-1	-1	-1	-1	-1	-1	9	2	-1	-1	-1	2	9	2	-1	-1	-1	2	9	2	-1	-1	-1	2	9	-1	-1	-1	-1	-1	-1	-1	-1	-1	-1	-1	-1	-1	-1	-1	-1	-1	-1	-1	-1	-1	-1	-1	-1	-1	-1	-1	-1	-1	-1	-1	-1	-1	-1	-1	-1	-1	9	1	-1	1	9	1	-1	1	9	1	-1	1	9	-1	-1	2	3	1	5	1	3	2	-1	-1	9	1	-1	1	9	1	-1	1	9	1	-1	1	9	-1	-1	-1	-1	-1	-1	-1	-1	-1	-1	-1	-1	-1	-1	-1	-1	-1	-1	-1	-1	-1	-1	-1	-1	-1	-1	-1	-1	-1	2	-1	7	-1	2	-1	7	-1	2	-1	7	-1	2	-1	7	-1	2	-1	-1	-1	-1	-1	-1	-1	-1	-1	-1	-1	-1	-1	-1	-1	-1	-1	-1	-1	-1	-1	-1	-1	-1	-1	-1	-1	-1	-1	-1	2	3	2	-1	-1	-1	-1	-1	-1	-1	-1	-1	-1	-1	-1	-1	-1	-1	-1	-1	-1	-1	-1	-1	-1	-1	-1	-1	-1	-1	1
1	-1	-1	-1	-1	-1	-1	-1	-1	-1	-1	-1	-1	2	2	2	2	2	-1	-1	-1	-1	-1	-1	-1	-1	-1	-1	-1	-1	-1	-1	-1	-1	-1	-1	-1	-1	-1	-1	-1	-1	-1	-1	-1	-1	-1	-1	-1	-1	-1	-1	2	-1	2	-1	-1	-1	2	-1	2	-1	-1	-1	2	-1	2	-1	-1	-1	-1	-1	-1	-1	-1	-1	-1	-1	-1	-1	-1	-1	-1	-1	-1	-1	-1	-1	-1	-1	-1	-1	-1	-1	-1	-1	-1	-1	-1	-1	-1	-1	-1	-1	-1	-1	-1	9	1	9	-1	9	1	9	-1	9	1	9	-1	-1	-1	2	3	3	1	3	3	2	-1	-1	-1	9	1	9	-1	9	1	9	-1	9	1	9	-1	-1	-1	-1	-1	-1	-1	-1	-1	-1	-1	-1	-1	-1	-1	-1	-1	-1	-1	-1	-1	-1	-1	-1	-1	-1	-1	-1	-1	-1	2	6	6	6	2	6	6	6	2	6	6	6	2	6	6	6	2	-1	-1	-1	-1	-1	-1	-1	-1	-1	-1	-1	-1	-1	11	11	11	11	11	11	11	11	-1	-1	-1	-1	-1	-1	-1	-1	-1	-1	2	-1	-1	-1	-1	-1	-1	-1	-1	-1	-1	-1	-1	-1	-1	-1	-1	-1	-1	-1	-1	-1	-1	-1	-1	-1	-1	-1	-1	1
1	-1	-1	-1	-1	-1	-1	-1	-1	-1	-1	-1	-1	3	3	11	11	3	-1	-1	-1	-1	-1	-1	-1	-1	-1	-1	-1	-1	-1	-1	-1	-1	-1	-1	-1	-1	-1	-1	-1	-1	-1	-1	-1	-1	-1	-1	-1	-1	-1	-1	-1	2	-1	-1	-1	-1	-1	2	-1	-1	-1	-1	-1	2	-1	-1	-1	-1	-1	-1	-1	-1	-1	-1	-1	-1	-1	-1	-1	-1	-1	-1	-1	-1	-1	-1	-1	-1	-1	-1	11	11	11	11	11	11	11	11	11	-1	-1	-1	-1	-1	-1	-1	-1	-1	-1	-1	-1	-1	-1	-1	-1	-1	-1	-1	-1	-1	-1	-1	-1	-1	-1	-1	-1	-1	-1	-1	-1	-1	-1	-1	-1	-1	-1	-1	-1	-1	-1	-1	-1	-1	-1	-1	-1	-1	-1	-1	-1	-1	-1	-1	11	11	11	11	11	11	11	-1	-1	-1	-1	-1	-1	-1	-1	-1	-1	-1	-1	-1	-1	-1	-1	-1	-1	-1	-1	-1	-1	-1	-1	-1	-1	-1	-1	-1	-1	-1	-1	-1	-1	-1	-1	0	0	0	2	2	2	2	2	2	2	2	-1	-1	-1	-1	-1	-1	-1	-1	-1	-1	-1	-1	-1	-1	-1	-1	-1	-1	-1	-1	-1	-1	-1	-1	-1	-1	-1	-1	-1	-1	-1	-1	-1	-1	-1	-1	-1	-1	-1	1
1	-1	-1	-1	-1	-1	-1	-1	-1	-1	-1	-1	-1	3	3	11	11	3	-1	-1	-1	-1	-1	-1	-1	-1	-1	-1	-1	-1	-1	-1	-1	11	11	11	11	11	11	-1	11	11	11	11	11	11	-1	-1	-1	-1	-1	-1	-1	9	-1	-1	-1	-1	-1	9	-1	-1	-1	-1	-1	9	-1	-1	-1	-1	-1	-1	-1	-1	-1	-1	-1	13	12	-1	-1	-1	-1	-1	-1	-1	-1	-1	-1	-1	-1	-1	2	2	2	2	2	2	2	2	2	-1	-1	-1	-1	-1	-1	-1	-1	-1	-1	-1	-1	-1	-1	-1	-1	-1	-1	-1	-1	-1	-1	-1	-1	-1	-1	-1	-1	-1	-1	-1	-1	-1	-1	-1	-1	-1	-1	-1	-1	-1	-1	-1	-1	-1	-1	-1	-1	-1	-1	-1	-1	-1	-1	-1	2	2	2	2	2	2	2	-1	-1	-1	-1	-1	-1	-1	-1	-1	-1	-1	-1	-1	-1	-1	-1	-1	-1	-1	-1	-1	-1	-1	-1	-1	-1	-1	-1	-1	-1	-1	-1	-1	-1	-1	-1	-1	-1	-1	-1	-1	-1	-1	-1	-1	-1	-1	2	-1	-1	-1	-1	-1	-1	-1	-1	-1	-1	-1	-1	-1	-1	-1	-1	-1	-1	-1	-1	-1	-1	-1	-1	-1	-1	11	-1	-1	-1	-1	-1	-1	-1	-1	-1	-1	-1	1
1	-1	-1	-1	-1	-1	-1	-1	-1	-1	2	2	2	2	2	2	2	2	2	-1	-1	-1	-1	-1	-1	-1	-1	-1	-1	-1	-1	-1	-1	2	2	2	2	2	2	-1	2	2	2	2	2	2	11	-1	-1	-1	-1	-1	-1	-1	-1	-1	-1	-1	-1	-1	-1	-1	-1	-1	-1	-1	-1	-1	-1	-1	-1	-1	0	0	0	0	1	1	1	1	0	0	0	-1	-1	-1	-1	-1	-1	-1	-1	2	9	2	3	-1	2	3	-1	2	9	2	-1	-1	-1	-1	-1	-1	-1	-1	-1	-1	-1	-1	-1	-1	-1	-1	-1	-1	-1	-1	-1	-1	-1	-1	-1	-1	-1	-1	-1	-1	-1	-1	-1	-1	-1	-1	-1	-1	-1	-1	-1	-1	-1	-1	-1	11	-1	-1	-1	-1	-1	-1	-1	2	3	3	3	3	3	3	3	2	-1	-1	-1	-1	-1	-1	-1	-1	-1	-1	-1	-1	-1	-1	-1	-1	-1	-1	-1	-1	-1	-1	-1	-1	-1	-1	-1	-1	-1	-1	-1	-1	-1	-1	-1	-1	-1	-1	-1	-1	-1	-1	-1	-1	-1	-1	-1	2	-1	-1	-1	-1	-1	-1	-1	-1	-1	-1	-1	-1	-1	-1	2	2	2	6	11	-1	-1	-1	-1	-1	11	6	11	-1	-1	-1	-1	-1	-1	-1	-1	-1	-1	1
1	-1	-1	-1	-1	-1	-1	-1	-1	-1	2	2	2	3	-1	-1	3	2	6	2	-1	-1	-1	-1	-1	-1	-1	-1	-1	-1	-1	2	2	2	2	2	9	9	2	-1	2	2	2	2	2	2	2	11	-1	-1	-1	-1	-1	-1	-1	-1	-1	-1	-1	-1	-1	-1	-1	-1	-1	-1	-1	-1	-1	-1	-1	-1	-1	-1	-1	-1	-1	-1	-1	-1	-1	-1	-1	-1	-1	-1	-1	-1	-1	-1	2	-1	7	2	-1	3	2	-1	3	2	7	-1	2	-1	-1	-1	-1	-1	-1	-1	-1	-1	-1	-1	-1	-1	-1	-1	-1	-1	-1	-1	-1	-1	-1	-1	-1	-1	-1	-1	-1	-1	-1	-1	-1	-1	-1	-1	-1	-1	-1	-1	-1	11	11	11	11	11	11	11	11	11	-1	-1	2	3	1	1	1	1	1	1	1	3	2	-1	-1	-1	-1	-1	-1	-1	-1	-1	-1	-1	-1	-1	-1	-1	-1	-1	-1	-1	-1	-1	-1	-1	-1	-1	-1	-1	-1	-1	-1	-1	-1	-1	-1	-1	-1	-1	-1	-1	-1	-1	-1	-1	-1	-1	-1	-1	2	-1	-1	-1	-1	-1	-1	-1	-1	-1	-1	-1	-1	-1	2	2	2	3	6	11	-1	-1	-1	11	6	3	6	11	-1	-1	-1	-1	-1	-1	-1	-1	-1	1
1	-1	-1	-1	-1	-1	-1	-1	-1	-1	2	2	2	-1	3	3	-1	2	1	6	2	-1	-1	-1	-1	-1	-1	-1	-1	-1	-1	2	2	2	2	2	3	3	2	-1	2	2	2	2	2	2	2	2	11	-1	-1	-1	-1	-1	-1	-1	-1	-1	-1	-1	-1	-1	-1	-1	-1	-1	-1	-1	-1	-1	-1	-1	-1	-1	-1	-1	-1	-1	-1	-1	-1	-1	-1	-1	-1	-1	-1	-1	-1	2	-1	7	-1	2	3	-1	2	3	-1	2	-1	7	-1	2	-1	-1	-1	-1	-1	-1	-1	-1	-1	-1	-1	11	11	11	11	11	11	-1	-1	-1	-1	-1	-1	-1	-1	-1	-1	-1	-1	-1	-1	-1	-1	-1	-1	-1	-1	-1	-1	2	2	2	2	2	2	2	2	2	-1	2	3	1	1	1	1	1	1	1	1	1	3	2	-1	-1	-1	-1	-1	-1	-1	-1	-1	-1	-1	-1	-1	-1	-1	-1	-1	-1	-1	-1	-1	-1	-1	-1	-1	-1	-1	-1	-1	-1	-1	-1	-1	2	2	2	-1	-1	-1	-1	-1	-1	-1	-1	-1	-1	-1	-1	-1	-1	-1	-1	-1	-1	-1	0	0	0	0	-1	2	2	2	-1	3	6	11	-1	11	6	3	-1	3	6	11	-1	-1	-1	-1	-1	-1	-1	-1	1
1	2	2	2	2	2	2	2	2	2	2	2	2	-1	3	3	-1	2	6	1	6	2	11	11	11	11	5	11	11	11	11	2	2	7	3	2	8	8	2	-1	2	2	2	6	3	6	2	2	2	11	-1	-1	-1	-1	-1	-1	-1	-1	-1	-1	-1	-1	-1	-1	-1	-1	-1	-1	-1	-1	-1	-1	-1	-1	-1	-1	-1	-1	-1	-1	-1	-1	-1	-1	-1	-1	-1	-1	2	10	7	-1	-1	2	-1	3	2	-1	3	2	-1	-1	7	10	2	-1	-1	-1	-1	-1	-1	-1	-1	-1	11	2	2	2	2	2	2	11	-1	-1	-1	-1	-1	-1	-1	-1	11	11	11	11	11	11	11	11	11	11	11	-1	-1	2	2	2	2	2	2	2	2	2	-1	2	3	3	3	3	3	3	3	3	3	3	3	2	-1	0	-1	2	2	2	-1	-1	-1	-1	-1	-1	-1	-1	-1	-1	-1	-1	-1	-1	-1	-1	-1	-1	11	11	11	-1	11	11	11	11	2	-1	-1	-1	2	-1	-1	-1	-1	-1	-1	-1	-1	-1	-1	-1	-1	-1	-1	-1	-1	-1	-1	-1	-1	-1	-1	-1	2	2	2	-1	-1	3	6	11	6	3	-1	-1	-1	3	6	11	-1	-1	-1	-1	-1	-1	-1	1
1	3	4	-1	4	6	4	-1	4	3	2	2	2	3	-1	-1	3	2	7	6	1	6	2	2	2	2	2	2	2	2	2	2	2	3	7	2	6	6	2	-1	2	2	2	3	6	3	2	2	2	2	11	-1	-1	-1	-1	-1	-1	-1	-1	-1	-1	-1	-1	-1	-1	-1	-1	-1	-1	-1	-1	-1	-1	-1	-1	-1	-1	-1	-1	-1	-1	-1	-1	-1	-1	-1	-1	2	10	-1	-1	7	-1	2	3	-1	2	3	-1	2	-1	7	-1	-1	10	2	-1	-1	-1	-1	-1	-1	-1	11	2	2	3	3	3	3	2	2	11	-1	-1	-1	-1	-1	-1	-1	2	2	2	2	2	2	2	2	2	2	2	-1	-1	2	2	2	2	2	2	2	2	2	-1	2	3	9	9	9	9	9	9	9	9	9	3	2	-1	-1	-1	2	2	2	-1	-1	-1	-1	-1	-1	-1	-1	-1	-1	-1	-1	-1	-1	-1	-1	-1	-1	2	2	2	-1	2	2	2	2	-1	-1	-1	-1	-1	2	2	2	2	2	-1	-1	-1	-1	-1	2	2	2	2	2	2	-1	-1	-1	-1	-1	-1	-1	2	2	2	-1	-1	-1	3	6	3	-1	-1	-1	-1	3	2	2	2	2	2	2	2	2	2	1
1	9	6	-1	6	7	6	-1	6	9	2	2	2	2	2	2	2	2	7	7	6	1	2	2	2	2	2	2	2	2	2	2	2	7	3	2	6	6	2	-1	2	2	2	6	3	6	2	2	2	2	11	-1	-1	-1	-1	-1	-1	-1	-1	-1	-1	-1	-1	-1	-1	-1	-1	-1	-1	-1	-1	-1	2	2	2	2	2	2	2	2	2	2	2	-1	-1	-1	2	10	-1	-1	-1	-1	7	2	-1	3	2	-1	3	2	7	-1	-1	-1	-1	10	2	-1	-1	-1	-1	-1	11	2	2	2	3	1	1	3	2	2	2	11	-1	-1	-1	-1	-1	-1	2	2	2	2	2	2	2	2	2	2	2	-1	-1	2	2	2	2	2	2	2	2	2	-1	2	3	8	8	8	8	8	8	8	8	8	3	2	-1	-1	-1	2	2	2	-1	-1	-1	-1	-1	-1	-1	-1	-1	-1	-1	-1	-1	-1	-1	-1	-1	-1	2	2	2	-1	2	2	2	2	-1	-1	-1	-1	-1	2	2	2	2	2	-1	-1	-1	-1	-1	2	3	4	3	4	2	5	5	5	5	5	5	5	2	2	2	-1	-1	-1	-1	-1	-1	-1	-1	-1	-1	3	3	3	3	3	3	3	3	3	3	1
1	3	9	6	5	5	5	6	9	3	2	2	2	2	2	2	2	2	5	5	5	6	2	2	2	2	2	2	2	2	2	2	2	3	7	2	6	6	2	-1	2	2	2	2	2	2	2	2	2	2	11	-1	11	11	11	11	11	11	11	5	5	5	11	11	11	11	11	11	-1	-1	-1	-1	2	2	2	2	2	2	2	2	2	2	2	-1	-1	2	4	8	8	8	8	8	8	2	3	-1	2	3	-1	2	8	8	8	8	8	8	4	2	-1	-1	-1	11	2	2	2	2	3	3	3	3	2	2	2	2	11	-1	-1	-1	-1	-1	2	2	2	2	2	2	2	2	2	2	2	5	5	2	2	2	2	2	2	2	2	2	-1	2	3	3	3	3	3	3	3	3	3	3	3	2	5	5	5	2	2	2	-1	-1	-1	11	11	11	11	11	11	11	11	11	11	11	11	11	-1	-1	2	2	2	5	2	2	2	2	-1	-1	-1	-1	-1	2	2	2	2	2	5	5	5	5	5	2	4	3	4	3	2	3	3	3	3	3	3	3	2	2	2	8	8	-1	-1	-1	-1	-1	-1	-1	-1	3	2	2	2	2	2	2	2	2	2	1
1	1	1	1	1	1	1	1	1	1	1	1	1	1	1	1	1	1	1	1	1	1	1	1	1	1	1	1	1	1	1	1	1	1	1	1	1	1	1	1	1	1	1	1	1	1	1	1	1	1	1	1	1	1	1	1	1	1	1	1	1	1	1	1	1	1	1	1	1	1	1	1	1	1	1	1	1	1	1	1	1	1	1	1	1	1	1	1	1	1	1	1	1	1	1	1	1	1	1	1	1	1	1	1	1	1	1	1	1	1	1	1	1	1	1	1	1	1	1	1	1	1	1	1	1	1	1	1	1	1	1	1	1	1	1	1	1	1	1	1	1	1	1	1	1	1	1	1	1	1	1	1	1	1	1	1	1	1	1	1	1	1	1	1	1	1	1	1	1	1	1	1	1	1	1	1	1	1	1	1	1	1	1	1	1	1	1	1	1	1	1	1	1	1	1	1	1	1	1	1	1	1	1	1	1	1	1	1	1	1	1	1	1	1	1	1	1	1	1	1	1	1	1	1	1	1	1	1	1	1	1	1	1	1	1	1	1	1	1	1	1	1	1	1	1	1	1	1	1	1
